1111111111111111111111
1E10000C00000000000001
10100101001000001C1011
1010010010101010001011
1P000000000C00000000C1
1111111111111111111111